0111022000000
0001022011111
0001022010000
0001022010000
0001000010000
0001000010000
0001111110000
0000000000000
3333333333333
